############
#          #
#   P   ####
#          #
# O      ###
##    O    #
###        #
#          #
# X   X    #
# #        #
############
