############
# P        #
#    O     #
##      ####
#     O    #
# X   X    #
#          #
#      z   #
############
